"aa" = (/turf/template_noop,/area/template_noop)
"ab" = (/turf/simulated/mineral/floor/sif,/area/submap/AegirianShip)
"ac" = (/turf/simulated/wall/titanium,/area/submap/AegirianShip)
"ad" = (/obj/machinery/door/airlock/alien/public,/turf/simulated/floor/tiled/monotile,/area/submap/AegirianShip)
"ae" = (/obj/structure/loot_pile/surface/alien,/turf/simulated/floor/tiled/monotile,/area/submap/AegirianShip)
"af" = (/turf/simulated/floor/plating,/area/submap/AegirianShip)
"ag" = (/obj/effect/decal/remains/ribcage,/turf/simulated/floor/tiled/monotile,/area/submap/AegirianShip)
"ah" = (/turf/simulated/floor/tiled/monotile,/area/submap/AegirianShip)
"ai" = (/obj/effect/decal/remains/ribcage,/turf/simulated/floor/plating,/area/submap/AegirianShip)
"aj" = (/obj/effect/wingrille_spawn/reinforced_phoron,/turf/simulated/floor/tiled/monotile,/area/submap/AegirianShip)
"ak" = (/obj/structure/bed/alien,/obj/effect/decal/cleanable/blood,/turf/simulated/floor/tiled/monotile,/area/submap/AegirianShip)
"al" = (/obj/effect/decal/cleanable/blood,/turf/simulated/floor/tiled/monotile,/area/submap/AegirianShip)
"am" = (/turf/simulated/shuttle/wall/alien,/area/submap/AegirianShip)
"an" = (/obj/effect/wingrille_spawn/reinforced_phoron,/turf/simulated/shuttle/floor/alienplating/external,/area/submap/AegirianShip)
"ao" = (/obj/structure/bed/alien,/obj/effect/decal/cleanable/greenglow,/obj/effect/decal/remains/ribcage,/turf/simulated/floor/tiled/monotile,/area/submap/AegirianShip)
"ap" = (/turf/simulated/shuttle/floor/alien,/area/submap/AegirianShip)
"aq" = (/mob/living/simple_animal/hostile/alien/drone{faction = "corrupted"; glow_color = "#11CC11"; glow_intensity = 1; light_color = "#33FF33"; light_range = 1; name = "corrupted drone"},/turf/simulated/shuttle/floor/alien,/area/submap/AegirianShip)
"ar" = (/obj/effect/decal/remains/ribcage,/turf/simulated/shuttle/floor/alien,/area/submap/AegirianShip)
"at" = (/obj/structure/bed/alien,/obj/effect/decal/cleanable/molten_item,/obj/effect/decal/cleanable/molten_item,/mob/living/simple_animal/hostile/alien/drone{faction = "corrupted"; glow_color = "#11CC11"; glow_intensity = 1; light_color = "#33FF33"; light_range = 1; name = "corrupted drone"},/turf/simulated/floor/tiled/monotile,/area/submap/AegirianShip)
"au" = (/mob/living/simple_animal/hostile/alien/drone{faction = "corrupted"; glow_color = "#11CC11"; glow_intensity = 1; light_color = "#33FF33"; light_range = 1; name = "corrupted drone"},/turf/simulated/floor/tiled/monotile,/area/submap/AegirianShip)
"av" = (/obj/structure/bed/alien,/obj/effect/decal/cleanable/molten_item,/obj/effect/decal/cleanable/molten_item,/obj/effect/decal/remains/ribcage,/turf/simulated/floor/tiled/monotile,/area/submap/AegirianShip)
"aw" = (/turf/simulated/shuttle/wall/alien/no_join,/area/submap/AegirianShip)
"ax" = (/obj/machinery/door/airlock/alien/public,/turf/simulated/shuttle/floor/alien,/area/submap/AegirianShip)
"ay" = (/obj/effect/decal/cleanable/greenglow,/turf/simulated/floor/plating,/area/submap/AegirianShip)
"az" = (/obj/effect/decal/cleanable/greenglow,/turf/simulated/floor/tiled/monotile,/area/submap/AegirianShip)
"aA" = (/obj/random/powercell,/obj/random/powercell,/obj/random/powercell,/obj/random/powercell,/obj/random/drinkbottle,/obj/random/drinkbottle,/obj/random/drinkbottle,/obj/random/drinkbottle,/obj/random/technology_scanner,/obj/random/technology_scanner,/obj/random/medical/pillbottle,/obj/random/plushie,/obj/structure/closet/crate/secure/loot,/obj/item/prop/alien/junk,/obj/item/prop/alien/junk,/obj/item/prop/alien/junk,/obj/item/prop/alien/junk,/obj/item/prop/alien/junk,/obj/item/prop/alien/junk,/obj/item/prop/alien/junk,/turf/simulated/shuttle/floor/alien,/area/submap/AegirianShip)
"aB" = (/obj/random/tool/alien,/obj/random/tool/alien,/obj/random/tool/alien,/obj/random/tool/alien,/obj/random/coin,/obj/random/coin,/obj/random/coin,/obj/random/coin,/obj/random/medical/pillbottle,/obj/random/medical/pillbottle,/obj/random/plushie,/obj/structure/closet/crate/secure/loot,/obj/item/prop/alien/junk,/obj/item/prop/alien/junk,/obj/item/prop/alien/junk,/obj/item/prop/alien/junk,/turf/simulated/shuttle/floor/alien,/area/submap/AegirianShip)
"aC" = (/turf/simulated/floor/tiled/dark,/area/submap/AegirianShip)
"aD" = (/obj/machinery/door/airlock/alien/locked,/turf/simulated/shuttle/floor/alienplating/external,/area/submap/AegirianShip)
"aE" = (/obj/machinery/door/airlock/alien/public,/turf/simulated/shuttle/floor/alienplating/external,/area/submap/AegirianShip)
"aF" = (/obj/machinery/door/airlock/alien/public,/turf/simulated/floor/tiled/dark,/area/submap/AegirianShip)
"aG" = (/obj/effect/decal/cleanable/blood,/turf/simulated/floor/tiled/dark,/area/submap/AegirianShip)
"aH" = (/mob/living/simple_animal/hostile/alien/drone{faction = "corrupted"; glow_color = "#11CC11"; glow_intensity = 1; light_color = "#33FF33"; light_range = 1; name = "corrupted drone"},/turf/simulated/floor/tiled/dark,/area/submap/AegirianShip)
"aI" = (/obj/structure/loot_pile/surface/alien,/turf/simulated/shuttle/floor/alien,/area/submap/AegirianShip)
"aJ" = (/obj/effect/decal/cleanable/molten_item,/turf/simulated/floor/tiled/dark,/area/submap/AegirianShip)
"aK" = (/obj/structure/bed/alien,/obj/random/powercell,/obj/random/powercell,/turf/simulated/shuttle/floor/alien,/area/submap/AegirianShip)
"aL" = (/obj/structure/bed/alien,/turf/simulated/shuttle/floor/alien,/area/submap/AegirianShip)
"aM" = (/obj/effect/decal/cleanable/blood,/obj/effect/decal/remains/ribcage,/turf/simulated/floor/tiled/monotile,/area/submap/AegirianShip)
"aN" = (/obj/machinery/door/airlock/alien/locked,/turf/simulated/floor/tiled/monotile,/area/submap/AegirianShip)
"aO" = (/obj/structure/table/alien,/obj/item/weapon/paper/alien,/turf/simulated/floor/tiled/monotile,/area/submap/AegirianShip)
"aP" = (/obj/structure/table/alien,/obj/item/prop/alien/junk,/turf/simulated/floor/tiled/monotile,/area/submap/AegirianShip)
"aQ" = (/obj/structure/table/alien,/obj/item/weapon/virusdish/random,/obj/item/weapon/virusdish/random,/obj/item/weapon/virusdish/random,/turf/simulated/shuttle/floor/alien,/area/submap/AegirianShip)
"aR" = (/obj/structure/closet/crate/secure/loot,/obj/random/medical,/obj/random/medical/lite,/obj/random/technology_scanner,/obj/random/trash,/obj/random/tool/alien,/obj/item/prop/alien/junk,/obj/effect/decal/cleanable/molten_item,/obj/effect/decal/cleanable/molten_item,/turf/simulated/floor/tiled/dark,/area/submap/AegirianShip)
"aS" = (/obj/structure/closet/crate/secure/loot,/obj/random/powercell,/obj/random/medical/lite,/obj/random/technology_scanner,/obj/random/trash,/obj/item/prop/alien/junk,/obj/item/prop/alien/junk,/turf/simulated/floor/tiled/dark,/area/submap/AegirianShip)
"aT" = (/obj/structure/table/bench/standard,/obj/effect/decal/remains/ribcage,/mob/living/simple_animal/hostile/alien/drone{faction = "corrupted"; glow_color = "#11CC11"; glow_intensity = 1; light_color = "#33FF33"; light_range = 1; name = "corrupted drone"},/turf/simulated/floor/tiled/monotile,/area/submap/AegirianShip)
"aU" = (/obj/structure/table/alien,/obj/random/tank,/obj/random/tank,/obj/random/firstaid,/turf/simulated/shuttle/floor/alien,/area/submap/AegirianShip)
"aV" = (/obj/random/junk,/turf/simulated/shuttle/floor/alien,/area/submap/AegirianShip)
"aW" = (/obj/machinery/crystal,/turf/simulated/shuttle/floor/alien,/area/submap/AegirianShip)
"aX" = (/obj/structure/loot_pile/surface/alien,/turf/simulated/floor/tiled/dark,/area/submap/AegirianShip)
"aY" = (/obj/structure/table/alien,/obj/random/contraband,/obj/item/clothing/accessory/medal/dungeon/alien_ufo,/turf/simulated/shuttle/floor/alien,/area/submap/AegirianShip)
"aZ" = (/obj/structure/closet/crate/secure/loot,/obj/random/powercell,/obj/random/medical/lite,/obj/random/trash,/obj/item/prop/alien/junk,/obj/item/prop/alien/junk,/obj/effect/decal/cleanable/molten_item,/turf/simulated/floor/tiled/dark,/area/submap/AegirianShip)
"ba" = (/obj/structure/closet/crate/secure/loot,/obj/random/powercell,/obj/random/medical/lite,/obj/item/prop/alien/junk,/obj/item/prop/alien/junk,/obj/effect/decal/cleanable/molten_item,/obj/effect/decal/cleanable/molten_item,/turf/simulated/floor/tiled/dark,/area/submap/AegirianShip)
"bb" = (/obj/structure/closet/crate/secure/loot,/obj/random/powercell,/obj/random/medical/lite,/obj/random/technology_scanner,/obj/random/trash,/obj/random/tool/alien,/obj/item/prop/alien/junk,/obj/item/prop/alien/junk,/turf/simulated/floor/tiled/dark,/area/submap/AegirianShip)
"bc" = (/obj/structure/closet/crate/secure/loot,/obj/random/powercell,/obj/random/medical/lite,/obj/random/technology_scanner,/obj/item/prop/alien/junk,/obj/item/prop/alien/junk,/turf/simulated/floor/tiled/dark,/area/submap/AegirianShip)

(1,1,1) = {"
aaaaaaaaaaaaaaaaaaaaaaaaaaaaaaaaaaaaaaaaaaaaaaaaaaaa
aaaaaaaaaaaaaaaaababaaaaaaabaaacacacacacacacadadacaa
aaaaaaaaaaaaabababababababababacaeafagahaiahafahadaa
aaaaaaababababababababababababajahakahahahahahaladaa
aaaaaaabamamananamamabababababajahaoahahahahahahacaa
aaaaaaaaamapaqarapamabababababajahatafahahauafahacaa
aaaaaaaaamapapapaqamabababababajahavafahahahahahacaa
aaaaaaamamawaxaxawamamababababacagahahahahayahazacaa
aaaaaaamaAapapapapaBamacacacacacaCahafalahahahahacaa
aaaaaaaDapapapapapapaEaFafaGaHaFafahahahafahahafacaa
aaaaaaawaIapapapapapawacacacacacaJahahahahahahahacaa
aaaaaaamawaxamamaxawamababababacazafahafahahahagacaa
aaaaaaaaamaqaKaLapamabababababacaeahaMahahahalafacaa
aaaaamamawarapapapawamamabababacacaNaNacacaOaPahacaa
aaamamaQawapapapaqawaLamamababacaRaCaCaSacahaTahacaa
aaamaUapaxapapapapaxaVaWamababacaXaCaCaCadafahahacaa
aaamamaYawamamamamawaLamamababacaZbabbbcacahahafacaa
aaaaamamamaaaaaaaaamamamababaaacacacacacacacacacacaa
aaaaaaaaaaaaaaaaaaaaaaaaaaaaaaaaaaaaaaaaaaaaaaaaaaaa
"}
